0000000000
0000000000
0000000000
0000000000
0000000000
0000000000
0000000000
0000000000
s00000000f
1111111111
