0000000000
0000000000
0000000000
0000000000
0000000000
0000000100
0000100100
0000000100
s00000000f
1111111111
