001f000000
0011100000
0000000000
0000100000
0000000000
0000100000
0000000000
0000100000
0000000000
s000000000
