f000000011
1101111001
1100111011
1110011001
0011011100
0000000010
0111001000
0001011111
0101010001
000000010s
