111f......
11111.....
11110.....
11111.....
11110.....
11111.....
11110.....
11111.....
1111s.....
1111111111
